#####################I###
##################### ###
#         ########### ###
######### ##      ### ###
######### ## #### ### ###
#####     ## #### ### ###
##### ###### #### ### ###
##### ###### #### ### ###
##### ###### #### ### ###
##### ###### #### ### ###
##### ###### #### ### ###
# ### ###### #### ### ###
# ### ###### #          #
# ### ###### ########## #
# ### ###### ########## #
# ### ###### ########## #
# ###                ## #
# ### ############## ## #
# ### ############## ## #
# ### ############## ## #
# ### ############## ## #
# ### ############## ## #
# ### ############## ## #
# ### ########### ## ## #
# ### ########### ## ## #
# ### ########### ## ## #
# ### ########### ## ## #
# ### ########### ## ## #
# ### ########### ## ## #
# ### ### ####### ## ####
#     ### ####### ## ####
# ####### ####### ## ####
# ####### ####### ## ####
# ####### ####### ## ####
# ####### ####### ## ####
# ####### ####### ## ####
# ####### ####### ## ####
# #######      ##    ####
# ############ ## #######
# ############ ## #######
# ############ ## #######
# ############ ## #######
# ############ ## #######
# ############ ## #######
# ############ ## #######
# ############ ## #######
# ############ ## #######
# ############ ## ##### #
# ############ ## ##### #
# ############ ## ##### #
# ############ ## ##### #
# ############ ## ##### #
# ############ ## ##### #
# ############ ## ##### #
# ############ ## ##### #
#              ## ##### #
############## ## ##### #
############## ## ##### #
############## ######## #
############## ######## #
############## ######## #
############## ######## #
############## ######## #
############## ######## #
############## ######## #
############## ######## #
############## ######## #
############## ######## #
############## ######## #
############## ######## #
############## ######## #
############## ######## #
############## ######## #
############## ######## #
############## ######## #
############## ######## #
############## ######## #
############## ######## #
############## ######## #
############## ######## #
#####                 # #
##### ######## ###### # #
##### ######## ###### # #
##### ######## ###### # #
##### ##     # ###### # #
##### ## ### # ###### # #
##### ## ### # ###### # #
##### ## ### # ###### # #
##### ## # # # ###### # #
##### ## # # # ###### # #
##### ## # # # ###### # #
##### ## # # # ###### # #
##### ## #   # ###### # #
##### ## ##### ###### # #
##### ## ##### ###### # #
##### ##       ###### # #
##### ############### # #
##### ###############   #
##### ###################
#####O###################